0-1
1111111111
1310110121
0000100001
1010010101
0401000141
1101101000
0000100010
1015001001
1100100001
0001001011
1-1
0100101011
1400000041
1000100011
0041004101
0500000501
1106060660
1110000111
1100000011
1000011011
1140000411
1-2
1140404001
1100000011
1040000001
1101111011
1060010601
1000046400
1100004010
1100700100
0107001001
0110110001
1-3
0000100001
1666666661
1000110001
1006000161
1004114001
1100010011
0041001401
1010100010
1000771000
1000110001
2-1
0014004000
0000100000
0010000000
1004014000
1006000110
1001700000
1004010401
0001000101
0001000701
0040100011
2-2
0100500011
0007000001
0100000011
0100070001
0100066000
0006006000
0111111100
1600000601
1000500100
0001010100
2-3
0000110000
0011000000
0000001100
0011100000
0400001110
0000000400
4111000000
0000111100
0600000000
0100010001
3-1
1004004001
0100000010
0010660100
0001001000
0001001000
0001001000
0010440100
0010000100
0014000100
0010001000
3-2
1100070011
1107000011
1000100000
0000010000
0001000000
0001000000
0010000000
0005000500
0011111100
1000000001
3-3
1100400011
0110000110
0011401100
0110600110
110000011
0001000000
0000600000
0004004000
0000000000
7770000777
4-1
0007007000
0044444000
1111000111
0000100000
1110000000
0000001111
0000000000
1111100000
0000000111
1110000000
4-2
1111110000
1111100600
1111111400
1111100040
0000000000
0000111111
1000000001
1111100000
0000000011
0004411144
4-3
0000500050
1000040010
0010000100
0000010000
1111040000
1004000111
0011100000
1004000111
1011100400
1000011100
5-1
1100011000
1000100001
1104000011
1100000411
1100000011
1110000111
1040050001
10006660001
1000000001
1000000001
5-2
1110001111
0000400000
0040001111
1111000000
0000011100
0004000040
1001110001
1000000001
1000000001
1000000001
5-3
1004004000
1110000000
0000700000
0000000700
0000100000
1000110000
0100606000
0040000400
0001100000
0000000001
