0-1
1111111111
1310110121
0000100001
1010010101
0401000141
1101101000
0000100010
1015001001
1100100001
0000001011
1-1
0100101011
1400000041
1000100011
0041004101
0500000501
1106060660
1110000111
1100000011
1000000111
1140000411
1-2
1140040011
1100000011
1000110001
1100110011
1060010601
1000000001
1000100010
1107007100
1000001000
0000000001
1-3
1000100001
1666666661
1000110001
1006000061
1004114001
1100010011
0001001001
1010100010
1000770000
1000000001
2-1
1110400011
1000000101
0010010001
1000000401
1006000011
1000700000
1000010001
1000000001
1000010001
1000700011
2-2
1000500001
0117007110
1100000011
1110000111
0100660011
1100000011
0000110000
1000000001
1150000511
1000000001
2-3
1000000001
0110000110
0011001100
0010000100
0000001110
0000000400
0110000110
0110000011
0006116000
1000000001
3-1
1040000401
0000110000
0010000100
0001001000
0001001000
0001001000
0010000100
0010000100
0100000010
0000000001
3-2
1000000001
1000500001
1000000001
0000110000
0000110000
1100000011
0110000111
0006006000
0000110000
0000000000
3-3
1000000001
0110000110
0010000100
0110000010
1100000011
0010000100
0010000010
0001000100
0000010000
1000000000
4-1
0000000000
1000000001
1114004111
0100000010
1000100001
0000100001
1000000001
1100000011
1100010011
0006006000
4-2
1000000001
1000010000
1140000401
1100010000
1100000001
1000000001
0001001000
0001001000
0010000100
0000606000
4-3
1000000001
1050010500
0041001400
0000110000
1000000001
0000000000
0000011000
1000000001
1001001000
1000000000
5-1
1100000011
1000000001
1104000011
1100000411
1100000011
1110000111
1000500001
1000101001
1000000001
1000000001
5-2
1000000001
0000700000
0040001111
1100000000
1000000000
1004000040
1000110001
1000000001
1000070001
1000000001
5-3
1000000000
1000000000
0010700100
0000000700
0000100000
1000010000
0100160600
0000000000
0001100000
1000000001
