0-1
1111111111
1310110121
0000100001
1010010101
0401000141
1101101000
0000100010
1015001001
1100100001
0001001011
1-1
0100101011
1101110001
1101110111
0001000101
0101010101
0000000060
1110110111
1100110011
1101111011
1100110011
1-2
1100011001
1001001011
1000000001
1101010101
1110010011
1100111010
0001000010
0101110000
0100011011
0110110001
1-3
0000100001
1666666661
1000110001
1006110161
1001110001
1100000011
0001101011
1010101010
1000000001
1110011001
2-1
0600100001
1010010101
0001060101
1101101000
0006000110
1010001001
1100100001
1001001101
0064001011
1100110001
2-2
0100110001
1150010001
1100001011
0001110001
0000100111
1010001001
1100100001
1110011011
0100001011
1100110001
2-3
1000000011
1100110011
1100111011
1000001010
1100011011
1110110001
1000001101
0011110001
1010101010
1611111611
3-1
1000000011
1110001101
0000100001
1010010101
0001000101
1101001000
0000000110
1010001001
1100100001
0001001101
